NO ./texture_no.png
SO ./texture_so.png
WE ./texture_we.png
EA ./texture_ea.png

F 69, 64, 64
C 28, 1, 54

111111111111111
100100000001001
100100011101001
100000000000001
100100011101001
100000000000001
100100011101001
100000000000001
100100011101001
100000000000001
100100011101001
100000000000001
100100011101001
100000000000001
100100011101001
100000000000001
100100011101001
100000000000001
100100011101001
100000000000001
100100011101001
100000000000001
100100011101001
100000000000001
100100011101001
100000000000001
111111000001111
     1000000001
     10000W1001
     1000000001
     1000000001
     1111111111